22222222222223111122
22222222222233111322
22222222222333311332
22222222223231111332
22222323322111113332
22223333332111333322
22223133112133333222
22322121112133332222
23231111212111123232
22111111111111113333
11111331111123113333
12111333111232113333
22211311111123112333
22333321111121111333
22233333332111111333
22333333333311333332
22233333333332233333
22333323333323333333
22233233333232333333
22222223322323222232
