22222222222222222222
22222222222222222222
22222222222222222222
22222222222222222222
22222222222222222222
22222222222222223232
22222222332323233333
22223323333233331333
22233332111333311132
22231111111111111122
22331111331322111122
22331111333223231111
22231111332222331111
22231111322223331323
22321111112323333232
22232313211333332322
22323333111333333322
22232231111333333232
22323221111123332322
22232111111222222222
