22222222222222222222
22222222222222222222
22222222222323232322
22222222223332323232
22222222323133232322
22222223231111133332
22222223111111123332
22222232111111133332
22222223311111113332
22222233341111113332
22222223311111111322
22222232311111111322
22222223323111111332
22222232331131111332
22222223321321123332
22222233131231223332
22222321111111233332
22222233121121124322
22222333142111133232
22222233212112112322
