22222222222222222222
22222222222222222222
22222222222222222222
22222222222222222222
22222222222222222222
22222222332323232322
22222223333333333332
22222222111333333332
22222232111313333322
22222321111111333322
22222231111111333332
22332211111111333332
23333111111111133332
22111122111111113332
11121131112111333322
13333331323333333322
11333331333333333332
13333331333332333332
13333311333322333322
22322212222222232222
