22222222222222222222
22222222222332323232
22222222223333333333
22222223322111333333
23322333332111333332
33333231111211133332
21111111121111133323
21113231121123233232
11132333331111333332
11133323311111113323
32333333311111113232
23333333311111112323
32333333322111211232
23111333332111111132
11111123311111111133
13112122211211132333
33131111111311223333
23311121133312232332
33333233233322223323
23322322322222222232
