22223221112222222222
22233111112323232322
22233111111232323232
22233321111323232322
22233321111133333332
23323121111113323332
33332121132113233332
21111111331113333322
11111113331112333322
11111112331123333232
33311113111333331322
33111112111233311111
23111111111323211111
33333333211121111132
23333332221111111123
33333322232311112232
23333222223333322323
33332222232333333332
23322222223333333332
22222222222233333322
