22222222222222222222
22222222222222222222
22222222222222222222
22222222222222222222
22333333333333333332
23333333333333343333
23113333333333333332
32111133332333333332
23111113321133223332
11111112111112333333
21111111111111233332
21111111111111333332
32312111112111133322
23211111113111333322
32331111113311113111
23331113333322111131
32333323333224333123
23333233332222333332
32332323322223433332
23222232222222333322
