22222223132323232322
22222233123232323232
22222233132333232322
22222223111323323222
22233222111111132222
22333321111112112322
23211111111111111332
32111111111111111332
23113211111111113332
21112321111111113332
22113322111111113332
22311332111111113332
23211331111111133332
22313311112111123322
21113332313111233332
21313322231111333332
11333222231111133322
12333333331111133332
23333333333211323332
22333333232222232322
