22222222222222222222
22222222222222222222
22222222222222222222
22222222222323232322
22222222223332323232
22222222223133332322
22222222232111333232
22222222321113311322
22222222331122311122
22222223311111111111
22222223311111131332
22222222311111133333
22222223231111133333
22222222333311123333
22222223233313111333
22222222333333111333
22222223233233132332
22222222333323133333
22222223233321133333
22222222323221233232
