22222222332222232322
22233223333111133332
22333322111111133332
23211112212211133342
32311211112111233332
11111233333111113322
21111113332311133232
21111112211111133332
21111112112111113323
21111111112121133231
33331131311121222211
23331133311111111112
33333133311111113112
23333233323111131111
33332333341111323111
23333333332311333333
33333333223333332332
23333333232333323333
33333432323333222332
23322323222232222222
