22222222222322232322
23232322333231323232
32333333333111112322
11333331111111111232
11111321111231211323
21111111113321211112
11111111113331211112
11111112113331122212
21111111123321111112
31311111111131111112
23113311111111111323
33333311121111111332
23333311111111111333
33333211111111111332
23333321121111111222
33333311111111111112
23333331221211111211
33333331211121111111
23332331211111111111
22222231211111111122
