22222222222222222222
22222222222222222222
22222222222222222222
22222222222222222222
22222222222222222222
22222222222233232322
22222222223333333332
22222222232311133332
22222222321111133332
22222223231111133332
22222222111111123322
22222233111111133232
22222331111111113332
22222233111122113333
22222333333331113332
22222233333333111323
22222333333333111232
22222233332313112323
22222333323211111232
22222233222311211122
