22111232323232323232
11132323333333333333
11233333333333333333
11323231113333333332
21111322111333333322
32311111111333333222
23231111111333332222
32333332311333322222
23233233321333222222
32332333331132222222
23233333321122222222
32333333331333333332
23233333311333333333
32333333312313333332
23233332311113333323
32333333211112332332
23233323311111111333
32332311111111231332
23223323111112321323
22222232221112231232
