22222222222222222222
22222222222222222222
22222222222222222222
22222223322222222222
22222233332323232322
22222221111333333332
22223221111333333332
22232311211333333332
22231111311333323332
22321113213333333332
22331111311133333322
23211311113331113232
23313211112321113332
31111311112111113333
33331111111111113332
33333311111111113333
33333313112111112332
33333313312211133333
33323333111111123332
23222223222211132222
